%%%%%%%%%%%%%%%%%%%%%%%%%%%%%%%%%
%  %   % % % % % % %     %      %
%  %%%   % %   % %   %%%   %%%  %
% %% %% %% %% %% %% %% %% %% %% %
%    %   %  %       %     %   % %
%%%% %%%%% %%%%% %%%%%%%%%%% %% %
%  % % % % %   % %   % % % % %  %
%    % %     %   %%%   % %     %%
%  % %   % % % %%%   % %   % %  %
% %% %%%%% %%%%% %% %% %% %%%%% %
%  % %      %   P    %  %     % %
% %% %%%%% %% %% %%%%% %%%%% %%%%
%  %%%   % %   % % % %%% % % %  %
%      %%% % %     % % % %     %%
%  % %   % % % % %   % %   %%%  %
% %%%%%%%% %%%%% %% %% %% %% %% %
%    %     %        %         %%%
%%%% %% %% %%%%% %% %% %% %%%%% %
%  % %   % %   %%%   % %   % %  %
%.     % %   % %   %   % %      %
%%%%%%%%%%%%%%%%%%%%%%%%%%%%%%%%%
