%%%%%%%%%%%%%%%%%%%%%%%%%%%
% %   %   %   %   %   %  P%
% % % % % %   % % % % % % %
%     % % %     % %   %   %
% % % % % %  %  % % % % % %
% % %   % % %%% % %     % %
% %%% % % %  %      % % % %
%   %           % % %   % %
%%% %   % % %   % % % % % %
%.      %   %   %   %   % %
%%%%%%%%%%%%%%%%%%%%%%%%%%%
