%%%%%%%%%%%%%%%%%%%%%%%%%%%%%%%%%
%      % %   %   % %   % %      %
%  % %   % %   %%%   % %   % %  %
% %%%%% %% %% %% %%%%% %% %% %%%%
%%%         %        %     %    %
% %% %% %% %% %% %%%%% %%%%%%%% %
%  %%%   % %   % % % % %   % %  %
%%     % % % %     % % %%%      %
%  % % % %%% % % %   % %   %%%  %
%%%% %%%%% %%%%% %% %% %%%%% %% %
% %     %  %    P   %      % %  %
% %%%%% %% %% %% %%%%% %%%%% %% %
%  % %   % %   %%% % % %   % %  %
%%     % %   %%%   %     % %    %
%  % % % % %   % %   % % % % %  %
% %% %%%%%%%%%%% %%%%% %%%%% %%%%
% %   %     %       %  %   %    %
% %% %% %% %% %% %% %% %% %% %% %
%  %%%   %%%   % %   % %   %%%  %
%      %     % % % % % % %   %. %
%%%%%%%%%%%%%%%%%%%%%%%%%%%%%%%%%
