%%%%%%%%%%%%%%%%
%   %         .%
% % %%%%%%%% %%%
%          %   %
% %%%  %%  % % %
%   % %%%% %   %
% % %  %%  %%% %
%   %          %
%%% %%%%%%%% % %
%P         %   %
%%%%%%%%%%%%%%%%
