%%%%%%%%%%%%%%%%
%   %         P%
% % %%%%%%%% %%%
%          %   %
%   %  %%  % % %
%   % %%%% %   %
% % %  %%  %   %
%              %
%%% %%%%%%%% % %
%.         %   %
%%%%%%%%%%%%%%%%
