%%%%%%%%%%%%%%%%%%%%%%%%%%%
%P%   %   %   %   %   %   %
% % % % % %   % % % % % % %
% %   % % %     % %   %   %
% % % % % %  %  % % % % % %
% % %   % % %%% % %   % % %
% % % % % %  %  % % % % % %
%   %   % %     % % %   % %
% % % % % % %   % % % % % %
%   %   %   %   %   %   %.%
%%%%%%%%%%%%%%%%%%%%%%%%%%%
